███████████████████████████████████████████████████████████████████████████████████████████████████████████
█.................█..................................█..................................█.......P.........█
█.████████.██████.█.██████.████████..████████.██████.█.██████.████████..████████.██████.█.██████.████████.█
█.........................................................................................................█
██████████.██████ █ ██████.██████████████████.██████ █ ██████.██████████████████.██████ █ ██████.██████████
██████████.█             █.██████████████████.█             █.██████████████████.█             █.██████████
██████████.█ █ ███████ █ █.██████████████████.█ █ ███████ █ █.██████████████████.█ █ ███████ █ █.██████████
          .  █         █  .                  .  █         █  .                  .  █         █  .          
██████████.█ ███████████ █.██████████████████.█ ███████████ █.██████████████████.█ ███████████ █.██████████
██████████.█             █.██████████████████.█             █.██████████████████.█             █.██████████
██████████.█ ███████████ █.██████████████████.█ ███████████ █.██████████████████.█ ███████████ █.██████████
█.................█..................................█..................................█.................█
█..........█......█......█....................█......█......█....................█......█......█..........█
█.████████.██████.█.██████.████████..████████.██████.█.██████.████████..████████.██████.█.██████.████████.█
█.........................................................................................................█
███████████████████████████████████████████████████████████████████████████████████████████████████████████