XXXXXXXXXXXXXXXXXXXXXXXXX
X.......X       X......PX
X.XXXX..XX     XX....XX.X
X.X..X.............X..X.X
X.XX.X.XXXXXXXXXXX.X.XX.X
X.......................X
XXXXXXXXXXXXXXXXXXXXXXXXX