XXXXXXXXXXXXXXXXXXXXXXXXXXXXXXXXXXXXXXXXXXXXXXXXXXXXXXXXXXXXXXXXXXXXXXXXXXX
X.......XG      X......PXX.......X       XG......XX.......X       X.......X
X.XXXX..XX     XX....XX.XX.XXXX..XX     XX....XX.XX.XXXX..XX     XX....XX.X
X.X..X.............X..X.XX.X..X.............X..X.XX.X..X.............X..X.X
X.XX.X.XXXXXXXXXXX.X.XX.XX.XX.X.XXXXXXXXXXX.XXXX.XX.XX.X.XXXXXXXXXXX.XXXX.X
X.........................................................................X
XXXXXXXXXXXXXXXXXXXXXXXXXXXXXXXXXXXXXXXXXXXXXXXXXXXXXXXXXXXXXXXXXXXXXXXXXXX