█████████████████████████████████████
█.................█................P█
█.████████.██████.█.██████.████████.█
█...................................█
██████████.██████ █ ██████.██████████
██████████.█             █.██████████
██████████.█ █ ███████ █ █.██████████
          .  █        G█  .          
██████████.█ ███████████ █.██████████
██████████.█             █.██████████
██████████.█ ███████████ █.██████████
█.................█.................█
█..........█......█......█..........█
█.████████.██████.█.██████.████████.█
█...................................█
█████████████████████████████████████